....................
....................
....................
....................
....................
....................
....................
....................
...........^^^^^^^..
....................
......###...........
................###.
.###................
....................
####################
