....................
....................
....................
....................
....................
....................
....................
....................
...........#######..
....................
......###...........
................###.
.###................
....................
####################
